 *==*               
 ** *==*   *==*     
  =    **  =  =     
 ****=*C=* =*3=     
**  *   =  =* =*    
 *P  T** *==*  *=*  
  **   =4  *  G 9*  
   *T  *==*T ** 8*  
    *        *===*  
    *==**9 F*=      
       *=*T*=*
