  *==*===========*  
 **  *           ** 
**     *8*9*9*8*  **
|  *** *=*=*=*=**  |
|  *||         |   |
|   |*=* *===* |*  |
|  *||4  *=*   |   |
|   **   *=*  P|*  |
|  *===T*======**  |
**  *8*8*9*8*8** C**
 ** G 3 D        ** 
 **=============**  