                    
      *=*=========* 
   *==**|   9     **
   = *+ |         C|
*==*9   |    =     |
|   *===*=====*    *
|     T 93    F   4P
===*    *=====*    |
   |    |   9    T |
   *==* |    F    **
      *=*==========
