*==================*
| T           9    |
*=*=========* *=*  |
| |         T |    |
| |FD 9     *=* *  |
| *=========* C |  |
| |  F G    *=* *  |
| | 9       T | |  |
*T*=========* *=*  |
P             F   4|
*==================*