                    
  **===============*
 **            4   |
**  *=======*9* *==*
*   |   3     |  9 |
|   | *=======*==* |
|   |       G |    |
|   *=======* | *==*
|   |   F     | C  |
*   | *======**==* |
|   |        |     |
*===*P=======*=====*
